707070707070708
808080808080808
707070707070708
808080808080808
707070707070708
808080808080808
707070707070708
808080808080808
707070707070708
808080808080808
707070707070708
808080808080808
707070707070708
808080808080808
800000000000009